ben+arbeid	benarbeid	ben+arbeid	ben+ar+be+id	
bingo+vinge	bingo+vinge	
bjelle+klang	bjelleklang	bjelle+klang	
blod+hevner	blodhevner	blodhevn+er	blod+hevner	blod+hevn+er	bl+od+hevner	bl+od+hevn+er	
blod+suger	blodsuger	blod+suger	blod+sug+er	bl+od+suger	bl+od+sug+er	
brakk+vann	brakkvann	brakk+vann	brak+kvann	
båt+fører	båtfører	båt+fører	båt+før+er	båt+fø+rer	
desimal+tall	desimaltall	desimalt+all	desimal+tall	desim+alt+all	desim+al+tall	de+si+malt+all	de+si+mal+tall	
edel+sten	edelsten	edel+sten	ed+el+sten	
en+tall	entall	ent+all	en+tall	
eple+kake	eplekake	eple+kake	ep+lek+ake	ep+le+kake	
etter+forskning	etterforskning	etter+forskning	ett+er+forskning	et+ter+forskning	
etter+navn	etternavn	etter+navn	ett+er+navn	et+ter+navn	
fag+dommer	fagdommer	fag+dommer	fag+dom+mer	fag+do+mm+er	
fag+forening	fagforening	fag+forening	fag+for+ening	
fem+minutter	fem+minutter	fem+minutt+er	fem+min+ut+ter	fem+mi+nut+ter	fe+mm+in+ut+ter	
fett+rand	fettrand	fett+rand	
fett+suging	fettsuging	fett+suging	
fjern+lys	fjernlys	fjern+lys	
flat+banker	flat+banker	flat+bank+er	
fler+tall	flertall	fler+tall	
fremmed+ord	fremmedord	fremmed+ord	frem+med+ord	
frem+pek	frempek	frem+pek	
frem+tid	fremtid	fremt+id	frem+tid	
fri+kirke	frikirke	fri+kirke	
førti+tall	førtitall	førti+tall	ført+it+all	før+titall	før+tit+all	før+ti+tall	
garn+fisker	garnfisker	garn+fisker	garn+fisk+er	
hel+tall	heltall	helt+all	hel+tall	
hval+ku	hvalku	hval+ku	
hver+dag	hverdag	hver+dag	
hånd+krem	hånd+krem	
hånd+verker	håndverker	håndverk+er	hånd+verker	hånd+verk+er	
is+lender	islender	is+lender	is+lend+er	is+len+der	
karnapp+vindu	karnappvindu	karnapp+vindu	karnapp+vin+du	kar+napp+vindu	kar+napp+vin+du	
lov+lærer	lov+lærer	lov+lær+er	
makt+haver	makthaver	makt+haver	makt+hav+er	
med+dele	meddele	med+dele	med+de+le	
mellom+navn	mellomnavn	mellom+navn	mel+lom+navn	
mellom+valg	mellom+valg	mel+lom+valg	
motor+vei	motorvei	motor+vei	mot+orv+ei	mot+or+vei	mo+torv+ei	
ned+bryter	nedbryter	nedbryt+er	ned+bryter	ned+bryt+er	ned+bry+ter	
nerve+pirrende	nervepirrende	nerve+pirrende	nerve+pirr+ende	nerve+pirr+en+de	nerve+pir+ren+de	
nest+kommanderende	nestkommanderende	nest+kommanderende	nest+kommander+ende	nest+kommander+en+de	nest+kom+man+der+ende	nest+kom+man+der+en+de	nest+kom+man+de+ren+de	
nåde+gave	nådegave	nåde+gave	nåde+ga+ve	nå+deg+ave	nå+de+gave	nå+de+ga+ve	
nød+rakett	nødrakett	nød+rakett	nød+rak+ett	
post+bud	postbud	post+bud	
prim+tall	primtall	primt+all	prim+tall	
regime+kritiker	regimekritiker	regime+kritiker	regime+kri+tiker	regime+kri+tik+er	
regn+vær	regnvær	regn+vær	
råd+giver	rådgiver	råd+giver	råd+giv+er	rå+dg+iver	
rør+legger	rørlegger	rør+legger	rør+legg+er	
sjø+røver	sjørøver	sjø+røver	sjø+røv+er	
skap+dranker	skapdranker	skap+dranker	skap+drank+er	
skog+bruker	skogbruker	skogbruk+er	skog+bruker	skog+bruk+er	
støv+suger	støvsuger	støvsug+er	støv+suger	støv+sug+er	
tall+følge	tall+følge	
tempel+ridder	tempel+ridder	tempel+ridd+er	tempel+rid+der	temp+el+ridder	temp+el+ridd+er	temp+el+rid+der	tem+pel+ridder	tem+pel+ridd+er	tem+pel+rid+der	
troll+øye	trolløye	troll+øye	
trykk+bølge	trykkbølge	trykk+bølge	
valg+urne	valgurne	valg+urne	valg+ur+ne	
vann+melon	vannmelon	vann+melon	
vin+gård	vingård	vin+gård	
vinkel+skriver	vinkelskriver	vinkel+skriver	vinkel+skriv+er	vink+elsk+river	vink+elsk+riv+er	vink+el+skriver	vink+el+skriv+er	
åpen+bare	åpenbare	åpen+bare	åpen+ba+re	
øyen+synlig	øyensynlig	øyen+synlig	øy+en+synlig	
det	det	
som	som	
til	til	
for	for	
med	med	
har	har	
den	den	
ikke	ikke	
han	han	
var	var	
jeg	jeg	
fra	fra	
men	men	
seg	seg	
kan	kan	
vil	vil	
ble	ble	
skal	skal	
hun	hun	
ntb	ntb	
ved	ved	
hadde	hadde	
etter	etter	ett+er	et+ter	
også	også	og+så	
være	være	
sier	sier	si+er	
nasjonal+forsamlingen	nasjonalforsamlingen	nasjonalforsamling+en	nasjonal+forsamlingen	nasjonal+forsamling+en	nasjonal+forsaml+ingen	nasjonal+forsaml+in+gen	nasjonal+for+samlingen	nasjonal+for+samling+en	nasjonal+for+saml+ingen	nasjonal+for+saml+in+gen	nasjonal+for+sa+ml+ingen	nasjonal+for+sa+ml+in+gen	nasjon+al+forsamlingen	nasjon+al+forsamling+en	nasjon+al+forsaml+ingen	nasjon+al+forsaml+in+gen	nasjon+al+for+samlingen	nasjon+al+for+samling+en	nasjon+al+for+saml+ingen	nasjon+al+for+saml+in+gen	nasjon+al+for+sa+ml+ingen	nasjon+al+for+sa+ml+in+gen	
takk+for+maten+taler	takk+format+ent+aler	takk+format+ent+al+er	takk+format+en+taler	takk+format+en+tal+er	takk+format+en+ta+ler	takk+forma+tent+aler	takk+forma+tent+al+er	takk+form+at+ent+aler	takk+form+at+ent+al+er	takk+form+at+en+taler	takk+form+at+en+tal+er	takk+form+at+en+ta+ler	takk+for+maten+taler	takk+for+maten+tal+er	takk+for+maten+ta+ler	takk+for+mat+ent+aler	takk+for+mat+ent+al+er	takk+for+mat+en+taler	takk+for+mat+en+tal+er	takk+for+mat+en+ta+ler	
hun+dyr	hund+yr	hun+dyr	
fagplan+arbeid	fagplan+arbeid	fagplan+ar+be+id	fag+plan+arbeid	fag+plan+ar+be+id	
